County,Fips,Region,Cases,Confirmed,Probable,PersonsWithNegativePCR,Est_Tot_Tests,Date,Last Date,Change From Last Date
ADAMS,42001,SC,398,386,12,6305,6691,7-13-2020,7-11-2020,180
ALLEGHENY,42003,SW,5033,4842,191,74752,79594,7-13-2020,7-11-2020,2706
ARMSTRONG,42005,SW,86,86,0,2688,2774,7-13-2020,7-11-2020,80
BEAVER,42007,SW,845,820,25,8077,8897,7-13-2020,7-11-2020,323
BEDFORD,42009,SC,92,85,7,1977,2062,7-13-2020,7-11-2020,52
BERKS,42011,SE,4700,4542,158,22466,27008,7-13-2020,7-11-2020,417
BLAIR,42013,SC,105,94,11,7304,7398,7-13-2020,7-11-2020,302
BRADFORD,42015,NC,59,52,7,3975,4027,7-13-2020,7-11-2020,24
BUCKS,42017,SE,6105,5559,546,43123,48682,7-13-2020,7-11-2020,688
BUTLER,42019,SW,429,389,40,8658,9047,7-13-2020,7-11-2020,309
CAMBRIA,42021,SW,137,116,21,10534,10650,7-13-2020,7-11-2020,414
CAMERON,42023,NW,4,4,0,290,294,7-13-2020,7-11-2020,2
CARBON,42025,NE,299,295,4,4885,5180,7-13-2020,7-11-2020,112
CENTRE,42027,NC,251,229,22,5704,5933,7-13-2020,7-11-2020,132
CHESTER,42029,SE,4016,3801,215,32569,36370,7-13-2020,7-11-2020,706
CLARION,42031,NW,63,59,4,1308,1367,7-13-2020,7-11-2020,139
CLEARFIELD,42033,NW,93,72,21,2875,2947,7-13-2020,7-11-2020,51
CLINTON,42035,NC,96,84,12,1803,1887,7-13-2020,7-11-2020,49
COLUMBIA,42037,NC,420,396,24,3686,4082,7-13-2020,7-11-2020,73
CRAWFORD,42039,NW,78,61,17,3607,3668,7-13-2020,7-11-2020,108
CUMBERLAND,42041,SC,951,906,45,13663,14569,7-13-2020,7-11-2020,231
DAUPHIN,42043,SC,2296,2234,62,21043,23277,7-13-2020,7-11-2020,372
DELAWARE,42045,SE,7569,7341,228,43794,51135,7-13-2020,7-11-2020,921
ELK,42047,NW,30,26,4,1357,1383,7-13-2020,7-11-2020,19
ERIE,42049,NW,718,612,106,13540,14152,7-13-2020,7-11-2020,349
FAYETTE,42051,SW,202,193,9,6219,6412,7-13-2020,7-11-2020,199
FOREST,42053,NW,7,5,2,320,325,7-13-2020,7-11-2020,3
FRANKLIN,42055,SC,1006,975,31,9870,10845,7-13-2020,7-11-2020,255
FULTON,42057,SC,19,17,2,584,601,7-13-2020,7-11-2020,8
GREENE,42059,SW,70,62,8,1689,1751,7-13-2020,7-11-2020,99
HUNTINGDON,42061,SC,260,253,7,1897,2150,7-13-2020,7-11-2020,28
INDIANA,42063,SW,156,146,10,3908,4054,7-13-2020,7-11-2020,91
JEFFERSON,42065,NW,39,32,7,1413,1445,7-13-2020,7-11-2020,19
JUNIATA,42067,SC,116,109,7,1042,1151,7-13-2020,7-11-2020,41
LACKAWANNA,42069,NE,1764,1705,59,14020,15725,7-13-2020,7-11-2020,436
LANCASTER,42071,SE,4851,4747,104,36255,41002,7-13-2020,7-11-2020,944
LAWRENCE,42073,NW,197,172,25,3645,3817,7-13-2020,7-11-2020,192
LEBANON,42075,SC,1448,1388,60,9926,11314,7-13-2020,7-11-2020,210
LEHIGH,42077,NE,4439,4388,51,29147,33535,7-13-2020,7-11-2020,583
LUZERNE,42079,NE,3024,2967,57,23417,26384,7-13-2020,7-11-2020,490
LYCOMING,42081,NC,247,229,18,5509,5738,7-13-2020,7-11-2020,169
MCKEAN,42083,NW,20,12,8,2286,2298,7-13-2020,7-11-2020,70
MERCER,42085,NW,175,152,23,5483,5635,7-13-2020,7-11-2020,307
MIFFLIN,42087,SC,74,69,5,3036,3105,7-13-2020,7-11-2020,64
MONROE,42089,NE,1473,1430,43,12281,13711,7-13-2020,7-11-2020,265
MONTGOMERY,42091,SE,8876,8861,15,68431,77292,7-13-2020,7-11-2020,1090
MONTOUR,42093,NC,79,71,8,4953,5024,7-13-2020,7-11-2020,118
NORTHAMPTON,42095,NE,3555,3443,112,27701,31144,7-13-2020,7-11-2020,455
NORTHUMBERLAND,42097,NC,346,312,34,4404,4716,7-13-2020,7-11-2020,88
PERRY,42099,SC,94,87,7,1982,2069,7-13-2020,7-11-2020,43
PHILADELPHIA,42101,SE,22987,22979,8,124218,147197,7-13-2020,7-11-2020,1414
PIKE,42103,NE,505,480,25,3461,3941,7-13-2020,7-11-2020,63
POTTER,42105,NC,18,15,3,372,387,7-13-2020,7-11-2020,17
SCHUYLKILL,42107,SE,776,748,28,9336,10084,7-13-2020,7-11-2020,159
SNYDER,42109,NC,72,61,11,1076,1137,7-13-2020,7-11-2020,26
SOMERSET,42111,SW,81,71,10,4302,4373,7-13-2020,7-11-2020,157
SULLIVAN,42113,NC,10,5,5,220,225,7-13-2020,7-11-2020,5
SUSQUEHANNA,42115,NE,196,189,7,2077,2266,7-13-2020,7-11-2020,31
TIOGA,42117,NC,29,23,6,1511,1534,7-13-2020,7-11-2020,170
UNION,42119,NC,100,90,10,3141,3231,7-13-2020,7-11-2020,175
VENANGO,42121,NW,38,25,13,1830,1855,7-13-2020,7-11-2020,210
WARREN,42123,NW,10,5,5,839,844,7-13-2020,7-11-2020,24
WASHINGTON,42125,SW,454,437,17,10815,11252,7-13-2020,7-11-2020,423
WAYNE,42127,NE,141,134,7,2867,3001,7-13-2020,7-11-2020,57
WESTMORELAND,42129,SW,1010,982,28,22322,23304,7-13-2020,7-11-2020,569
WYOMING,42131,NE,47,44,3,1325,1369,7-13-2020,7-11-2020,29
YORK,42133,SC,1858,1811,47,26619,28430,7-13-2020,7-11-2020,557
