County,Fips,Region,Cases,Confirmed,Probable,PersonsWithNegativePCR,Est_Tot_Tests,Date,Last Date,Change From Last Date
ADAMS,42001,SC,409,394,15,6690,7084,7-16-2020,7-15-2020,191
ALLEGHENY,42003,SW,5750,5558,192,82675,88233,7-16-2020,7-15-2020,1171
ARMSTRONG,42005,SW,96,96,0,2912,3008,7-16-2020,7-15-2020,34
BEAVER,42007,SW,893,866,27,8436,9302,7-16-2020,7-15-2020,75
BEDFORD,42009,SC,95,88,7,2061,2149,7-16-2020,7-15-2020,35
BERKS,42011,SE,4763,4603,160,23439,28042,7-16-2020,7-15-2020,371
BLAIR,42013,SC,118,107,11,7764,7871,7-16-2020,7-15-2020,121
BRADFORD,42015,NC,61,54,7,4279,4333,7-16-2020,7-15-2020,98
BUCKS,42017,SE,6228,5676,552,45666,51342,7-16-2020,7-15-2020,993
BUTLER,42019,SW,456,412,44,9349,9761,7-16-2020,7-15-2020,110
CAMBRIA,42021,SW,153,132,21,11277,11409,7-16-2020,7-15-2020,219
CAMERON,42023,NW,5,5,0,298,303,7-16-2020,7-15-2020,1
CARBON,42025,NE,309,305,4,5164,5469,7-16-2020,7-15-2020,146
CENTRE,42027,NC,262,240,22,6053,6293,7-16-2020,7-15-2020,135
CHESTER,42029,SE,4129,3913,216,34512,38425,7-16-2020,7-15-2020,442
CLARION,42031,NW,67,64,3,1460,1524,7-16-2020,7-15-2020,9
CLEARFIELD,42033,NW,96,74,22,3040,3114,7-16-2020,7-15-2020,68
CLINTON,42035,NC,100,88,12,1884,1972,7-16-2020,7-15-2020,37
COLUMBIA,42037,NC,427,403,24,3903,4306,7-16-2020,7-15-2020,81
CRAWFORD,42039,NW,104,87,17,3904,3991,7-16-2020,7-15-2020,172
CUMBERLAND,42041,SC,985,933,52,14352,15285,7-16-2020,7-15-2020,147
DAUPHIN,42043,SC,2342,2275,67,21750,24025,7-16-2020,7-15-2020,177
DELAWARE,42045,SE,7696,7467,229,46456,53923,7-16-2020,7-15-2020,653
ELK,42047,NW,32,27,5,1447,1474,7-16-2020,7-15-2020,27
ERIE,42049,NW,756,642,114,14275,14917,7-16-2020,7-15-2020,259
FAYETTE,42051,SW,223,215,8,6719,6934,7-16-2020,7-15-2020,162
FOREST,42053,NW,7,5,2,372,377,7-16-2020,7-15-2020,17
FRANKLIN,42055,SC,1033,997,36,10244,11241,7-16-2020,7-15-2020,126
FULTON,42057,SC,19,17,2,609,626,7-16-2020,7-15-2020,11
GREENE,42059,SW,77,70,7,1912,1982,7-16-2020,7-15-2020,47
HUNTINGDON,42061,SC,263,256,7,2120,2376,7-16-2020,7-15-2020,150
INDIANA,42063,SW,174,162,12,4212,4374,7-16-2020,7-15-2020,130
JEFFERSON,42065,NW,41,34,7,1518,1552,7-16-2020,7-15-2020,21
JUNIATA,42067,SC,116,109,7,1105,1214,7-16-2020,7-15-2020,28
LACKAWANNA,42069,NE,1777,1718,59,14516,16234,7-16-2020,7-15-2020,175
LANCASTER,42071,SE,4951,4842,109,38491,43333,7-16-2020,7-15-2020,678
LAWRENCE,42073,NW,209,184,25,3845,4029,7-16-2020,7-15-2020,57
LEBANON,42075,SC,1481,1418,63,10293,11711,7-16-2020,7-15-2020,110
LEHIGH,42077,NE,4495,4443,52,30740,35183,7-16-2020,7-15-2020,605
LUZERNE,42079,NE,3042,2980,62,24359,27339,7-16-2020,7-15-2020,256
LYCOMING,42081,NC,259,236,23,5934,6170,7-16-2020,7-15-2020,232
MCKEAN,42083,NW,20,12,8,2484,2496,7-16-2020,7-15-2020,46
MERCER,42085,NW,208,182,26,5924,6106,7-16-2020,7-15-2020,80
MIFFLIN,42087,SC,76,71,5,3172,3243,7-16-2020,7-15-2020,77
MONROE,42089,NE,1487,1444,43,12902,14346,7-16-2020,7-15-2020,259
MONTGOMERY,42091,SE,8999,8984,15,71412,80396,7-16-2020,7-15-2020,1160
MONTOUR,42093,NC,82,73,9,5161,5234,7-16-2020,7-15-2020,87
NORTHAMPTON,42095,NE,3601,3487,114,29131,32618,7-16-2020,7-15-2020,543
NORTHUMBERLAND,42097,NC,355,321,34,4858,5179,7-16-2020,7-15-2020,255
PERRY,42099,SC,96,88,8,2066,2154,7-16-2020,7-15-2020,27
PHILADELPHIA,42101,SE,23395,23387,8,131114,154501,7-16-2020,7-15-2020,2352
PIKE,42103,NE,509,484,25,3583,4067,7-16-2020,7-15-2020,38
POTTER,42105,NC,19,16,3,490,506,7-16-2020,7-15-2020,28
SCHUYLKILL,42107,SE,792,762,30,9784,10546,7-16-2020,7-15-2020,183
SNYDER,42109,NC,74,63,11,1137,1200,7-16-2020,7-15-2020,17
SOMERSET,42111,SW,88,78,10,4549,4627,7-16-2020,7-15-2020,62
SULLIVAN,42113,NC,10,5,5,227,232,7-16-2020,7-15-2020,3
SUSQUEHANNA,42115,NE,195,188,7,2197,2385,7-16-2020,7-15-2020,29
TIOGA,42117,NC,32,26,6,1643,1669,7-16-2020,7-15-2020,34
UNION,42119,NC,108,96,12,3464,3560,7-16-2020,7-15-2020,47
VENANGO,42121,NW,49,33,16,2051,2084,7-16-2020,7-15-2020,14
WARREN,42123,NW,11,5,6,889,894,7-16-2020,7-15-2020,12
WASHINGTON,42125,SW,518,499,19,11458,11957,7-16-2020,7-15-2020,230
WAYNE,42127,NE,144,137,7,2970,3107,7-16-2020,7-15-2020,25
WESTMORELAND,42129,SW,1089,1057,32,23469,24526,7-16-2020,7-15-2020,389
WYOMING,42131,NE,48,45,3,1393,1438,7-16-2020,7-15-2020,24
YORK,42133,SC,1942,1894,48,27632,29526,7-16-2020,7-15-2020,372
