County,Fips,Region,Cases,Confirmed,Probable,PersonsWithNegativePCR,Est_Tot_Tests,Date,Last Date,Change From Last Date
ADAMS,42001,SC,341,330,11,5119,5449,7-1-2020,7-1-2020,0
ALLEGHENY,42003,SW,2870,2722,148,55605,58327,7-1-2020,7-1-2020,0
ARMSTRON,42005,SW,76,76,0,2166,2242,7-1-2020,7-1-2020,0
BEAVER,42007,SW,678,658,20,6260,6918,7-1-2020,7-1-2020,0
BEDFORD,42009,SC,87,79,8,1527,1606,7-1-2020,7-1-2020,0
BERKS,42011,SE,4559,4402,157,19594,23996,7-1-2020,7-1-2020,0
BLAIR,42013,SC,72,66,6,5695,5761,7-1-2020,7-1-2020,0
BRADFORD,42015,NC,58,52,6,3570,3622,7-1-2020,7-1-2020,0
BUCKS,42017,SE,5777,5238,539,36565,41803,7-1-2020,7-1-2020,0
BUTLER,42019,SW,311,278,33,6864,7142,7-1-2020,7-1-2020,0
CAMBRIA,42021,SW,83,63,20,7790,7853,7-1-2020,7-1-2020,0
CAMERON,42023,NW,3,3,0,264,267,7-1-2020,7-1-2020,0
CARBON,42025,NE,280,276,4,4231,4507,7-1-2020,7-1-2020,0
CENTRE,42027,NC,205,191,14,4322,4513,7-1-2020,7-1-2020,0
CHESTER,42029,SE,3731,3520,211,26794,30314,7-1-2020,7-1-2020,0
CLARION,42031,NW,35,35,0,999,1034,7-1-2020,7-1-2020,0
CLEARFIELD,42033,NW,72,54,18,2337,2391,7-1-2020,7-1-2020,0
CLINTON,42035,NC,80,70,10,1382,1452,7-1-2020,7-1-2020,0
COLUMBIA,42037,NC,403,380,23,3106,3486,7-1-2020,7-1-2020,0
CRAWFORD,42039,NW,57,44,13,2514,2558,7-1-2020,7-1-2020,0
CUMBERLA,42041,DSC,856,819,37,11394,12213,7-1-2020,7-1-2020,0
DAUPHIN,42043,SC,2059,2004,55,17803,19807,7-1-2020,7-1-2020,0
DELAWARE,42045,SE,7230,7005,225,37116,44121,7-1-2020,7-1-2020,0
ELK,42047,NW,15,12,3,973,985,7-1-2020,7-1-2020,0
ERIE,42049,NW,620,535,85,11676,12211,7-1-2020,7-1-2020,0
FAYETTE,42051,SW,117,111,6,4921,5032,7-1-2020,7-1-2020,0
FOREST,42053,NW,7,5,2,246,251,7-1-2020,7-1-2020,0
FRANKLIN,42055,SC,940,912,28,8613,9525,7-1-2020,7-1-2020,0
FULTON,42057,SC,18,16,2,498,514,7-1-2020,7-1-2020,0
GREENE,42059,SW,41,38,3,1252,1290,7-1-2020,7-1-2020,0
HUNTINGD,42061,NSC,252,245,7,1609,1854,7-1-2020,7-1-2020,0
INDIANA,42063,SW,111,102,9,2966,3068,7-1-2020,7-1-2020,0
JEFFERSON,42065,NW,24,21,3,1119,1140,7-1-2020,7-1-2020,0
JUNIATA,42067,SC,111,104,7,854,958,7-1-2020,7-1-2020,0
LACKAWAN,42069,NAE,1707,1649,58,11553,13202,7-1-2020,7-1-2020,0
LANCASTER,42071,SE,4464,4371,93,30382,34753,7-1-2020,7-1-2020,0
LAWRENCE,42073,NW,103,91,12,2693,2784,7-1-2020,7-1-2020,0
LEBANON,42075,SC,1350,1291,59,8624,9915,7-1-2020,7-1-2020,0
LEHIGH,42077,NE,4258,4208,50,24386,28594,7-1-2020,7-1-2020,0
LUZERNE,42079,NE,2915,2866,49,19581,22447,7-1-2020,7-1-2020,0
LYCOMING,42081,NC,187,182,5,4142,4324,7-1-2020,7-1-2020,0
MCKEAN,42083,NW,18,10,8,1514,1524,7-1-2020,7-1-2020,0
MERCER,42085,NW,140,121,19,4217,4338,7-1-2020,7-1-2020,0
MIFFLIN,42087,SC,63,60,3,2453,2513,7-1-2020,7-1-2020,0
MONROE,42089,NE,1423,1381,42,10455,11836,7-1-2020,7-1-2020,0
MONTGOM,42091,RSYE,8483,8468,15,58772,67240,7-1-2020,7-1-2020,0
MONTOUR,42093,NC,74,66,8,4379,4445,7-1-2020,7-1-2020,0
NORTHAMP,42095,NOEN,3425,3323,102,23723,27046,7-1-2020,7-1-2020,0
NORTHUMB,42097,NRCLAND,314,285,29,3497,3782,7-1-2020,7-1-2020,0
PERRY,42099,SC,86,79,7,1593,1672,7-1-2020,7-1-2020,0
PHILADELPHI,42101,SE,21724,21716,8,105490,127206,7-1-2020,7-1-2020,0
PIKE,42103,NE,496,471,25,3064,3535,7-1-2020,7-1-2020,0
POTTER,42105,NC,16,12,4,300,312,7-1-2020,7-1-2020,0
SCHUYLKILL,42107,SE,747,720,27,7916,8636,7-1-2020,7-1-2020,0
SNYDER,42109,NC,66,55,11,909,964,7-1-2020,7-1-2020,0
SOMERSET,42111,SW,61,51,10,3624,3675,7-1-2020,7-1-2020,0
SULLIVAN,42113,NC,5,4,1,182,186,7-1-2020,7-1-2020,0
SUSQUEHA,42115,NAE,182,176,6,1721,1897,7-1-2020,7-1-2020,0
TIOGA,42117,NC,25,19,6,1141,1160,7-1-2020,7-1-2020,0
UNION,42119,NC,91,83,8,2343,2426,7-1-2020,7-1-2020,0
VENANGO,42121,NW,19,15,4,1200,1215,7-1-2020,7-1-2020,0
WARREN,42123,NW,7,5,2,695,700,7-1-2020,7-1-2020,0
WASHINGT,42125,NSW,230,217,13,7823,8040,7-1-2020,7-1-2020,0
WAYNE,42127,NE,140,131,9,2428,2559,7-1-2020,7-1-2020,0
WESTMORE,42129,ASWND,675,648,27,17698,18346,7-1-2020,7-1-2020,0
WYOMING,42131,NE,38,36,2,1098,1134,7-1-2020,7-1-2020,0
YORK,42133,SC,1531,1475,56,22222,23697,7-1-2020,7-1-2020,0
