County,Fips,Region,Cases,Confirmed,Probable,PersonsWithNegativePCR,Est_Tot_Tests,Date,Last Date,Change From Last Date
ADAMS,42001,SC,385,372,13,6139,6511,7-11-2020,7-10-2020,109
ALLEGHENY,42003,SW,4762,4571,191,72317,76888,7-11-2020,7-10-2020,1871
ARMSTRONG,42005,SW,84,84,0,2610,2694,7-11-2020,7-10-2020,26
BEAVER,42007,SW,823,798,25,7776,8574,7-11-2020,7-10-2020,78
BEDFORD,42009,SC,92,85,7,1925,2010,7-11-2020,7-10-2020,59
BERKS,42011,SE,4680,4522,158,22069,26591,7-11-2020,7-10-2020,310
BLAIR,42013,SC,102,91,11,7005,7096,7-11-2020,7-10-2020,154
BRADFORD,42015,NC,59,52,7,3951,4003,7-11-2020,7-10-2020,42
BUCKS,42017,SE,6064,5518,546,42476,47994,7-11-2020,7-10-2020,507
BUTLER,42019,SW,410,370,40,8368,8738,7-11-2020,7-10-2020,157
CAMBRIA,42021,SW,132,111,21,10125,10236,7-11-2020,7-10-2020,171
CAMERON,42023,NW,4,4,0,288,292,7-11-2020,7-10-2020,0
CARBON,42025,NE,297,293,4,4775,5068,7-11-2020,7-10-2020,47
CENTRE,42027,NC,241,225,16,5576,5801,7-11-2020,7-10-2020,241
CHESTER,42029,SE,3992,3778,214,31886,35664,7-11-2020,7-10-2020,766
CLARION,42031,NW,60,57,3,1171,1228,7-11-2020,7-10-2020,51
CLEARFIELD,42033,NW,85,67,18,2829,2896,7-11-2020,7-10-2020,56
CLINTON,42035,NC,95,83,12,1755,1838,7-11-2020,7-10-2020,26
COLUMBIA,42037,NC,419,395,24,3614,4009,7-11-2020,7-10-2020,71
CRAWFORD,42039,NW,77,61,16,3499,3560,7-11-2020,7-10-2020,131
CUMBERLAND,42041,SC,935,891,44,13447,14338,7-11-2020,7-10-2020,200
DAUPHIN,42043,SC,2279,2216,63,20689,22905,7-11-2020,7-10-2020,232
DELAWARE,42045,SE,7513,7286,227,42928,50214,7-11-2020,7-10-2020,441
ELK,42047,NW,29,25,4,1339,1364,7-11-2020,7-10-2020,23
ERIE,42049,NW,707,604,103,13199,13803,7-11-2020,7-10-2020,330
FAYETTE,42051,SW,194,185,9,6028,6213,7-11-2020,7-10-2020,174
FOREST,42053,NW,7,5,2,317,322,7-11-2020,7-10-2020,1
FRANKLIN,42055,SC,997,966,31,9624,10590,7-11-2020,7-10-2020,68
FULTON,42057,SC,19,17,2,576,593,7-11-2020,7-10-2020,1
GREENE,42059,SW,67,59,8,1593,1652,7-11-2020,7-10-2020,53
HUNTINGDON,42061,SC,257,250,7,1872,2122,7-11-2020,7-10-2020,30
INDIANA,42063,SW,141,132,9,3831,3963,7-11-2020,7-10-2020,41
JEFFERSON,42065,NW,37,31,6,1395,1426,7-11-2020,7-10-2020,21
JUNIATA,42067,SC,116,109,7,1001,1110,7-11-2020,7-10-2020,25
LACKAWANNA,42069,NE,1756,1698,58,13591,15289,7-11-2020,7-10-2020,219
LANCASTER,42071,SE,4816,4715,101,35343,40058,7-11-2020,7-10-2020,381
LAWRENCE,42073,NW,171,148,23,3477,3625,7-11-2020,7-10-2020,182
LEBANON,42075,SC,1429,1372,57,9732,11104,7-11-2020,7-10-2020,127
LEHIGH,42077,NE,4424,4373,51,28579,32952,7-11-2020,7-10-2020,757
LUZERNE,42079,NE,3002,2944,58,22950,25894,7-11-2020,7-10-2020,361
LYCOMING,42081,NC,240,225,15,5344,5569,7-11-2020,7-10-2020,69
MCKEAN,42083,NW,20,12,8,2216,2228,7-11-2020,7-10-2020,15
MERCER,42085,NW,166,145,21,5183,5328,7-11-2020,7-10-2020,160
MIFFLIN,42087,SC,72,67,5,2974,3041,7-11-2020,7-10-2020,85
MONROE,42089,NE,1470,1427,43,12019,13446,7-11-2020,7-10-2020,202
MONTGOMERY,42091,SE,8828,8813,15,67389,76202,7-11-2020,7-10-2020,915
MONTOUR,42093,NC,77,69,8,4837,4906,7-11-2020,7-10-2020,70
NORTHAMPTON,42095,NE,3546,3434,112,27255,30689,7-11-2020,7-10-2020,436
NORTHUMBERLAND,42097,NC,343,310,33,4318,4628,7-11-2020,7-10-2020,97
PERRY,42099,SC,91,84,7,1942,2026,7-11-2020,7-10-2020,26
PHILADELPHIA,42101,SE,22840,22832,8,122951,145783,7-11-2020,7-10-2020,1431
PIKE,42103,NE,504,479,25,3399,3878,7-11-2020,7-10-2020,43
POTTER,42105,NC,18,15,3,355,370,7-11-2020,7-10-2020,9
SCHUYLKILL,42107,SE,773,744,29,9181,9925,7-11-2020,7-10-2020,153
SNYDER,42109,NC,72,61,11,1050,1111,7-11-2020,7-10-2020,15
SOMERSET,42111,SW,76,66,10,4150,4216,7-11-2020,7-10-2020,54
SULLIVAN,42113,NC,10,5,5,215,220,7-11-2020,7-10-2020,1
SUSQUEHANNA,42115,NE,193,187,6,2048,2235,7-11-2020,7-10-2020,29
TIOGA,42117,NC,29,23,6,1341,1364,7-11-2020,7-10-2020,53
UNION,42119,NC,98,88,10,2968,3056,7-11-2020,7-10-2020,97
VENANGO,42121,NW,35,22,13,1623,1645,7-11-2020,7-10-2020,41
WARREN,42123,NW,9,5,4,815,820,7-11-2020,7-10-2020,11
WASHINGTON,42125,SW,430,413,17,10416,10829,7-11-2020,7-10-2020,331
WAYNE,42127,NE,141,134,7,2810,2944,7-11-2020,7-10-2020,46
WESTMORELAND,42129,SW,975,949,26,21786,22735,7-11-2020,7-10-2020,385
WYOMING,42131,NE,44,41,3,1299,1340,7-11-2020,7-10-2020,25
YORK,42133,SC,1830,1788,42,26085,27873,7-11-2020,7-10-2020,326
